x b g o .
g . . . .
. x . g .
. . . . x
. . . . .